------------------------------------------------------------------------------------------------------------
Shorter sentences
------------------------------------------------------------------------------------------------------------

Se Lever    			(need a LEVER to get this man up!)
S'entrendre Avec		(ENTer (RE) at the END (RE) to get on with me!)
Se coucher			("To lie down" on the COUCH (ER)

L'escalier			(ESCApe the LIER under the stairs)
Ascenseur			ASCENd up the lift
La Clé				Key was made of clay
Secours				Emergency

quelquefois			Sometimes
	
seulement			Only

le neveu			Nephew
Le jumeau / la jumelle		Twins (stuck together like jume)
Veuf				Widowed
C'est-à-dire			i.e. Set a Deer loose!
le plus jeune			Youngest (m)
Vieux (Vuh)			Old (m)
vieille (V-A) 			Old (f)

du beurre			Butter (the big bear was covered in butter)
des céréales			Cereal. Cere Ales (lovely beer)
le dernier 			Last (Dernia is the "last" word in cosmetics)

Comment s'appelle-t-elle?	What is her name?
vous vous levez à quelle heure?	You get up at what time (formal)
tu te couches à quelle heure?	You go to bed at what time (formal)
comment s'appelle votre fille?	What is your daughter called?

du pain grillé			Toast

j'aime faire de la natation	I like to swim
Se reposer			To rest
La lecture			Reading
j'aime aller au théâtre		I like to go to the theatre
j'aime me promener		I like to walk
J'aime lire un livre		I like reading a book
j'aime écouter de la musique	I like to listen to music

Cela coûte			It costs
En provenance / À destination   Going from, going to
le guichet			Ticket office
La salle d'attente		Waiting room
la consigne			Left luggage office
Le bureau des objets trouvés	Lost property office
L'hoaire			Timetable
l'arrêt d'autobus		Bus Stop
la clé / votre clés		The key / your key
La sortie de secours		Emergency Exit
Il est en panne			Out of order
la note, l'addition		Bill (causal / restaurant)
Fiche de réservation		Booking form


long court étroit serré large	long short narrow tight wide


------------------------------------------------------------------------------------------------------------
Longer Sentences
------------------------------------------------------------------------------------------------------------

quel est votre passetemps favori?				What is your favourite pastimes?
à quelle heure est le prochain train pour Paris?		At what time est the next train for Paris?
attention! le train pour à destination de Belfast va partir	The train for belfast is now leaving
à quelle heure est le dernier train?				At what time is the last train?
vous pouvez me montrer votre passeport?				Can you show me your passport?



Je vous prie d'agréer, Monsieur/Madame, l'expression de mes salutations distinguées
Tip (John Vergo Plays darts almost murdering mother! Lee Evans dates massive slimey dragon!)
